{
    "height":5, 
    "width":5, 
    "layer0":[
        [9, 9, 9, 9, 9,9, 9, 9, 9, 9],
        [9, 9, 9, 9, 9,9, 9, 9, 9, 9],
        [9, 9, 9, 9, 9,9, 9, 9, 9, 9],
        [9, 9, 9, 9, 9,9, 9, 9, 9, 9],
        [9, 9, 9, 9, 9,9, 9, 9, 9, 9],
        [9, 9, 9, 9, 9,9, 9, 9, 9, 9],
        [9, 9, 9, 9, 9,9, 9, 9, 9, 9],
        [9, 9, 9, 9, 9,9, 9, 9, 9, 9],
        [9, 9, 9, 9, 9,9, 9, 9, 9, 9],
        [9, 9, 9, 9, 9,9, 9, 9, 9, 9]],
     
    "layer1":[
        [0, 1, 0, 0, 0,0, 0, 0, 0, 0],
        [0, 0, 0, 0, 0,0, 0, 0, 3, 0],
        [0, 0, 0, 0, 0,3, 0, 0, 0, 0],
        [0, 2, 0, 2, 0,0, 0, 0, 0, 0],
        [0, 0, 0, 0, 0,0, 1, 0, 0, 0],
        [0, 3, 0, 0, 0,0, 0, 0, 0, 0],
        [0, 0, 0, 0, 0,0, 0, 0, 1, 0],
        [0, 0, 0, 0, 0,2, 0, 0, 0, 0],
        [0, 1, 0, 2, 0,0, 0, 0, 0, 0],
        [0, 0, 0, 0, 0,0, 1, 0, 0, 0]]
 
}