{
    "height": 5,
    "width":5,
    "layer0":[
        [9,1,1,1,1],
        [9,1,9,1,1],
        [9,1,9,9,1],
        [9,1,9,9,9],
        [9,1,9,9,9]],
    
    "layer1":[
        [0,0,0,0,0],
        [0,0,2,0,0],
        [0,0,0,0,0],
        [0,8,0,2,0],
        [5,0,0,0,0]],
        
    "layer2":[
        [0,0,0,0,0],
        [0,0,0,0,0],
        [0,0,0,0,0],
        [0,0,0,0,0],
        [0,0,0,0,0]]
    }